 
  11111111
 1........1
 1........1
 1.p...b..1
 1.....b..1
 1........1
 1........1
 1......t.1
 1......t.1
  1111111