000022222222220000002222222200
000021111111111111111111111200
000021333333333333333333331200
000021322222220000002222231200
000021333333333320000000231200
000021111111111320000000031000
000022220000001320000000031000
000000000000001300000000031000
222222220000001300000000031000
111111120000001300000000031000
333333120000021300000000031000
222223120000021320000000231200
000023120000021320000000231200
000003100000021320000000231200
000003100000021320000000444400
000023122220001320000000444400
000023111111111320000000444400
000023333333333300000000444400
000022222220000000000000000000
000000000000000000000000000000